10 10 1
1111111111
1111111111
2222122222
1111311111
2212222222
1111111111
2222212222
1111111111
1112222222
1111111011