25 25 2
1111111111111111111111111
2222222222222221222222222
1121112111121111211111112
1221112112121222212222222
1121111112111111211111111
1221222222222222222222221
1121111121111111211111111
1221111121111111212222222
1121111121111111211111111
1121222222222211222222221
1221211111111211211111111
1121222223222211212222222
1221111111111111211111111
1122212222222222222222221
1111112111111111211111111
1222222322222222212222222
1111112111131111211111111
1111112111122221222222221
1122222122221211211111111
1121112111121221212222222
1222212222121111211111111
1111112111121222222122222
2232222122221211111111111
1111111111121111211111111
2222222222222222211111101