10 10 0
1111111111
2211111111
1211111111
1211111111
1211111111
1211111111
1222222222
1211211111
0211211111
1211211111