25 25 3
1111111111111111111111111
2222222221222222222222222
1111111121111111111111111
1222222122222222222222221
1111112111111111111111111
2222212222222222222222222
1111112111111212121212121
1222222122221212121212121
1111112121121212121212121
2222212121121212121212121
1111112111121212121212121
1222222222221212121212121
1211111111111111111111111
1222221222222222222222221
1111111211112111112111121
2222222232112111212111121
1111131112111111212232221
2221222222222111211111111
1111111111112222222222222
2222222222112111111111111
1111111112112221222222221
1222122212111111211112111
1111111112112222211111111
2122222222222111222221222
0111111111111111111111111