10 10 1
1111111111
1111111111
2222322222
1111111111
2212222222
1111111111
2222212222
1111111111
1112222222
1111111011