10 20 1
11111111111111111111
11111111111112223222
22222222222222111111
11111111111112222212
11111111111111111111
12222222222222222222
11111111111111111111
12222212222122222222
12111111112121111112
11111111110111111111