25 25 1
1111111111111111111111111
2222222222222222222222221
1111111111111111111111111
2122222222222222222222222
2121111111111111111111111
2121222222222222222222221
2121111111111111111111121
2111112112112112112111121
2222222222222222222222221
1111111111111111111111111
1222222222222222222222222
1111111111111111111111111
2222221111111111112223222
1111112222222222222111111
1111121111111111111211111
1111211222222222221121111
1112111111111111112112111
1121112111111111111211211
1121112122222222222221121
1111111111111111111111111
2222222212222222222222222
2111111112111111111111112
2122222222102222222222212
2121112111212111111111112
2111211121112222222222222
