10 10 1
1111111111
1111111111
1111111111
1111111111
3222322222
1211111111
1222222223
1111111111
2222222221
0111111111